0 0 0 0 0 0 0 0 0 0 0 0 0 0 0 0 0 0 0 0 0 0 0 0 0 0 0 0 0 0 0 5
0 0 0 0 0 0 0 0 0 0 0 0 0 0 0 0 0 0 0 0 0 0 0 0 0 0 0 0 0 0 0 5
7 1 0 0 0 0 0 0 0 0 0 0 0 0 0 0 0 0 0 0 0 0 0 0 0 0 0 0 0 0 0 5
4 2 0 0 0 0 3 7 1 0 0 0 0 0 0 0 0 0 0 0 0 0 0 0 0 0 0 0 0 0 0 5
4 8 0 0 0 0 5 4 4 1 0 0 0 0 0 0 0 0 0 0 0 0 0 0 0 0 0 0 0 0 0 5
2 0 0 0 0 0 5 4 4 4 7 1 0 0 0 0 0 3 7 7 7 7 1 0 0 0 0 0 0 0 3 4
2 0 0 0 0 3 4 4 4 4 4 4 7 7 7 7 7 4 4 4 4 4 4 7 7 7 7 7 7 7 4 4
2 0 0 0 0 5 4 4 4 4 4 4 4 4 4 4 4 4 4 4 4 4 4 4 4 4 4 4 4 4 4 4
2 0 0 0 0 5 4 4 4 4 4 4 4 4 4 4 4 4 4 4 4 4 4 4 4 4 4 4 4 4 4 4
4 1 0 0 0 5 4 4 6 6 6 4 4 6 6 6 6 6 6 6 4 4 4 4 4 6 6 6 6 6 6 4
4 2 0 0 0 5 4 8 0 0 0 9 8 0 0 0 0 0 0 0 9 6 6 6 6 0 0 0 0 0 0 5
4 8 0 0 0 9 8 0 0 0 0 0 0 0 0 0 0 0 0 0 0 0 0 0 0 0 0 0 0 0 0 5
2 0 0 0 0 0 0 0 0 0 0 0 0 0 0 0 0 0 0 0 0 0 0 0 0 0 0 0 0 0 0 5
2 0 0 0 0 0 0 0 0 0 0 0 0 0 0 0 0 0 0 0 0 0 0 0 0 0 0 0 0 0 0 5
4 7 7 7 7 7 7 7 7 7 7 7 7 7 7 7 7 7 7 7 7 7 7 7 7 7 7 7 7 7 7 4
4 4 4 4 4 4 4 4 4 4 4 4 4 4 4 4 4 4 4 4 4 4 4 4 4 4 4 4 4 4 4 4

64 319 0

8
848 143       
825 118       
871 118       
802 93       
894 93       
848 93       
848 59       
848 29  

2
440 320 0
550 320 0

720 350

800 375 1

1
400 443

1
400 243

1
35 416 

1
2 400 143 460 143 400 143 

