0 0 0 0 0 0 0 0 0 5 4 2 0 0 0 0 0 0 0 0 0 0 0 0 0 0 0 0 0 0 0 0
0 0 0 0 0 0 0 0 0 5 4 2 0 0 0 0 0 0 0 0 0 0 0 0 0 0 0 0 0 0 0 0
0 0 0 0 0 0 0 0 0 5 4 2 0 0 0 0 0 0 0 0 0 0 0 0 0 0 0 0 0 0 0 0
0 0 0 0 0 0 0 0 0 9 6 8 0 0 0 0 0 0 0 0 0 0 0 0 0 3 7 7 1 0 0 0
0 0 0 0 0 0 0 0 0 0 0 0 0 0 0 0 0 0 0 0 0 0 0 0 7 4 4 4 4 0 0 0
0 0 0 0 0 0 0 0 0 0 0 0 0 0 0 0 0 0 0 0 0 0 0 0 0 0 0 0 0 0 0 0
0 0 0 0 0 3 1 0 0 0 0 0 0 0 0 3 7 7 7 1 0 0 0 0 0 0 0 0 0 0 0 0
7 1 0 0 0 5 2 0 0 0 0 0 0 0 0 0 9 4 4 2 0 0 0 0 0 0 0 0 0 0 0 0
4 4 0 0 0 5 2 0 0 0 0 0 0 0 0 0 0 9 4 2 0 0 0 7 7 7 7 7 7 1 0 0
0 0 0 0 3 4 2 0 0 0 0 0 0 0 0 0 0 0 9 2 0 0 0 0 0 0 0 0 0 4 7 7
0 0 0 0 0 5 2 0 0 0 0 0 0 0 0 0 0 0 0 2 0 0 0 0 0 0 0 0 0 0 4 4
0 0 0 0 0 5 2 0 0 0 3 7 7 1 0 0 0 0 0 2 0 0 0 0 0 0 0 0 0 0 0 4
0 0 0 0 0 5 2 0 0 0 5 4 4 2 0 0 0 0 0 4 7 7 7 7 7 7 7 7 7 7 7 4
7 7 7 7 7 4 2 0 0 0 5 4 4 2 0 0 0 0 0 4 4 4 4 4 4 4 4 4 4 4 4 4
4 4 4 4 4 4 4 0 0 0 5 4 4 2 0 0 0 0 0 4 4 4 4 4 4 4 4 4 4 4 4 4
4 4 4 4 4 4 4 0 0 0 5 4 4 2 0 0 0 0 0 4 4 4 4 4 4 4 4 4 4 4 4 4

64 375 0

13
299 200
314 230
332 255
364 292
390 306
429 259
467 201
472 158
499 122
511 88
547 74
795 216
993 167

1
1 289 0

733 286

800 315 1

2
760 250
975 283

2
820 46
839 46

1
10 193

1
3 780 207 840 207 760 207

1
376 322

0
