0 0 0 0 0 0 0 0 0 5 4 2 0 0 0 0 0 0 0 0 0 0 0 0 0 0 0 0 0 0 0 0
0 0 0 0 0 0 0 0 0 5 4 2 0 0 0 0 0 0 0 0 0 0 0 0 0 0 0 0 0 0 0 0
0 0 0 0 0 0 0 0 0 5 4 2 0 0 0 0 0 0 0 0 0 0 0 0 0 0 0 0 0 0 0 0
0 0 0 0 0 0 0 0 0 9 6 8 0 0 0 0 0 0 0 0 0 0 0 0 0 3 7 7 1 0 0 0
0 0 0 0 0 0 0 0 0 0 0 0 0 0 0 0 0 0 0 0 0 0 0 0 7 4 4 4 4 0 0 0
0 0 0 0 0 0 0 0 0 0 0 0 0 0 0 0 0 0 0 0 0 0 0 0 0 0 0 0 0 0 0 0
0 0 0 0 0 3 1 0 0 0 0 0 0 0 0 0 0 0 3 1 0 0 0 0 0 0 0 0 0 0 0 0
7 1 0 0 0 5 2 0 0 0 0 0 0 0 0 0 0 0 0 2 0 0 0 0 0 0 0 0 0 0 0 0
4 4 0 0 0 5 2 0 0 0 0 0 0 0 0 0 0 0 0 2 0 0 0 7 7 7 7 7 7 1 0 0
0 0 0 0 0 5 2 0 0 0 0 0 0 0 0 0 0 0 0 2 0 0 0 0 0 0 0 0 0 4 7 7
0 0 0 0 0 5 2 0 0 0 0 0 0 0 0 0 0 0 0 2 0 0 0 0 0 0 0 0 0 0 4 4
0 0 0 0 0 5 2 0 0 0 0 3 7 1 0 0 0 0 0 2 0 0 0 0 0 0 0 0 0 0 0 4
0 0 0 0 0 5 2 0 0 0 0 5 4 2 0 0 0 0 0 4 7 7 7 7 7 7 7 7 7 7 7 4
7 7 7 7 7 4 2 0 0 0 0 5 4 2 0 0 0 0 0 4 4 4 4 4 4 4 4 4 4 4 4 4
4 4 4 4 4 4 4 0 0 0 0 5 4 2 0 0 0 0 0 4 4 4 4 4 4 4 4 4 4 4 4 4
4 4 4 4 4 4 4 0 0 0 0 5 4 2 0 0 0 0 0 4 4 4 4 4 4 4 4 4 4 4 4 4
