4 4 4 4 4 4 4 4 6 6 6 6 6 6 6 6 6 6 6 4 2 0 0 0 0 0 0 0 0 0 0 0
4 4 4 6 6 6 4 2 0 0 0 0 0 0 0 0 0 0 5 4 2 0 0 0 0 0 0 0 0 0 0 0
6 6 8 0 0 0 9 8 0 0 0 0 0 0 0 0 0 0 9 6 8 0 0 0 0 0 0 0 7 7 7 7
0 0 0 0 0 0 0 0 0 0 0 0 0 0 0 0 0 0 0 0 0 0 0 0 0 0 0 0 0 0 0 0
0 0 0 0 0 0 0 0 0 0 0 0 0 0 0 0 0 0 0 0 0 0 0 0 0 0 0 0 0 0 0 0
0 0 0 0 0 0 0 0 0 0 0 0 0 0 0 0 0 0 0 0 0 0 0 0 7 7 0 0 0 0 0 0
0 0 0 0 0 0 0 0 0 0 0 0 0 0 0 0 0 0 3 7 1 0 0 0 0 0 0 0 0 0 0 0
0 0 0 0 0 0 3 1 0 0 0 0 0 0 0 0 0 0 5 4 2 0 0 0 0 0 0 0 0 0 0 0
7 7 7 7 7 7 4 4 7 7 0 0 0 0 0 0 0 0 5 4 2 0 0 0 0 0 0 7 7 0 0 0
4 4 4 4 4 4 4 4 4 0 0 0 0 0 0 0 0 0 5 4 2 0 0 0 0 0 0 0 0 0 0 0
0 0 0 0 0 0 0 0 0 0 0 0 0 0 0 0 0 0 5 4 2 0 7 7 0 0 0 0 0 0 0 0
0 0 0 0 0 0 0 0 0 0 0 0 0 0 0 0 0 0 5 4 2 0 0 0 0 0 0 0 0 0 0 0
0 0 0 0 0 0 0 0 0 0 0 0 0 0 0 0 0 0 5 4 2 0 0 0 0 0 0 0 0 0 0 0
7 7 7 7 7 7 7 7 0 0 0 0 7 7 7 0 0 0 5 4 2 0 0 0 0 0 0 0 0 3 7 7
4 4 4 4 4 4 4 4 0 0 0 0 4 4 4 0 0 0 5 4 2 0 0 0 0 0 7 7 0 5 4 4
4 4 4 4 4 4 4 4 0 0 0 0 4 4 4 0 0 0 5 4 4 7 7 0 0 0 0 0 0 5 4 4

64 375 0

8
125 215
372 301
524 473
550 324
773 475
844 279
969 183
550 74

3
90 97 0
130 97 0
493 32 0

618 94

950 16 1

1
5 251

1
112 54

1
950 385

2
2 170 366 220 366 170 366
1 36  206 70  206 36  206

1
420 385

0