0 0 0 0 0 0 0 0 0 0 0 0 0 0 0 0 0 0 0 0 0 0 0 0 0 0 0 0 0 0 0 5
0 0 0 0 0 0 0 0 0 0 0 0 0 0 0 0 0 0 0 0 0 0 0 0 0 0 0 0 0 0 0 5
0 0 0 0 0 0 0 0 0 0 0 0 0 7 7 0 0 0 0 0 0 0 0 0 0 0 0 0 0 0 0 5
7 7 7 1 0 0 0 0 0 0 0 0 0 0 0 0 0 0 0 0 0 0 0 0 0 0 3 7 7 7 7 4
4 4 4 4 7 7 7 1 0 0 0 0 0 0 0 0 0 0 0 0 0 0 0 0 0 0 5 4 4 4 4 4
4 4 4 4 4 4 4 2 0 0 0 0 0 0 0 0 0 0 0 0 0 0 0 0 0 0 5 4 4 4 4 4
4 4 4 4 4 4 4 2 0 0 0 0 0 0 0 3 7 7 1 0 0 0 0 0 0 0 5 4 4 4 4 4
4 4 4 4 4 4 4 2 0 0 0 0 0 0 0 5 4 4 2 0 0 0 0 0 0 0 5 4 4 4 4 4
4 4 4 4 4 4 4 2 0 0 0 0 0 0 0 9 6 6 8 0 0 0 0 0 0 0 9 6 6 6 6 6
4 4 4 4 4 4 4 2 0 0 0 7 7 0 0 0 0 0 0 0 0 7 7 0 0 0 0 0 0 0 0 0
4 4 4 6 6 6 6 8 0 0 0 0 0 0 0 0 0 0 0 0 0 0 0 0 0 0 0 0 0 0 0 0
4 4 2 0 0 0 0 0 0 0 0 0 0 0 0 0 0 0 0 0 0 0 0 0 0 0 0 0 0 0 0 0
4 4 2 0 0 0 0 0 0 0 0 0 0 0 0 0 0 0 0 0 1 0 0 3 7 7 7 7 7 7 7 7
4 4 4 7 7 7 7 7 7 7 7 7 7 7 1 0 0 0 0 3 2 0 0 5 4 4 4 4 4 4 4 4
4 4 4 4 4 4 4 4 4 4 4 4 4 4 4 7 7 7 7 4 2 0 0 5 4 4 4 4 4 4 4 4
4 4 4 4 4 4 4 4 4 4 4 4 4 4 4 4 4 4 4 4 4 7 7 4 4 4 4 4 4 4 4 4

760 300 1

10
572  110 
533  71 
506  42 
428  119 
392 170 
370  224 
334  171 
261  84 
299  116 
218  69 

4
485 172 1
540 172 1
562 420 1
482 420 1

832 285

880 310 1

2
685 475
96  411

2
200 60
830 60

1
60 66

1
2 200 369 280 369 200 369

2
690 256
375 256

1
434 33
1
670 385 1