0 0 0 0 0 0 0 0 0 0 0 0 0 0 0 0 0 0 0 0 0 0 0 0 0 0 0 0 0 0 0 5
0 0 0 0 0 0 0 0 0 0 0 0 0 0 0 0 0 0 0 0 0 0 0 0 0 0 0 0 0 0 0 5
0 0 0 0 0 0 0 0 0 0 0 0 0 7 7 0 0 0 0 0 0 0 0 0 0 0 0 0 0 0 0 5
7 7 7 1 0 0 0 0 0 0 0 0 0 0 0 0 0 0 0 0 0 0 0 0 0 0 3 7 7 7 7 4
4 4 4 4 7 7 7 1 0 0 0 0 0 0 0 0 0 0 0 0 0 0 0 0 0 0 5 4 4 4 4 4
4 4 4 4 4 4 4 2 0 0 0 0 0 0 0 0 0 0 0 0 0 0 0 0 0 0 5 4 4 4 4 4
4 4 4 4 4 4 4 2 0 0 0 0 0 0 0 3 7 7 1 0 0 0 0 0 0 0 5 4 4 4 4 4
4 4 4 4 4 4 4 2 0 0 0 0 0 0 0 5 4 4 2 0 0 0 0 0 0 0 5 4 4 4 4 4
4 4 4 4 4 4 4 2 0 0 0 0 0 0 0 9 6 6 8 0 0 0 0 0 0 0 9 6 6 6 6 6
4 4 4 4 4 4 4 2 0 0 0 7 7 0 0 0 0 0 0 0 0 7 7 0 0 0 0 0 0 0 0 0
4 4 4 6 6 6 6 8 0 0 0 0 0 0 0 0 0 0 0 0 0 0 0 0 0 0 0 0 0 0 0 0
4 4 2 0 0 0 0 0 0 0 0 0 0 0 0 0 0 0 0 0 0 0 0 0 0 0 0 0 0 0 0 0
4 4 2 0 0 0 0 0 0 0 0 0 0 0 0 0 0 0 0 0 1 0 0 3 7 7 7 7 7 7 7 7
4 4 4 7 7 7 7 7 7 7 7 7 7 7 1 0 0 0 0 3 2 0 0 5 4 4 4 4 4 4 4 4
4 4 4 4 4 4 4 4 4 4 4 4 4 4 4 7 7 7 7 4 2 0 0 5 4 4 4 4 4 4 4 4
4 4 4 4 4 4 4 4 4 4 4 4 4 4 4 4 4 4 4 4 4 7 7 4 4 4 4 4 4 4 4 4
