6 6 6 6 6 0 0 0 0 0 0 0 0 6 6 6 4 4 4 4 4 2 0 0 0 0 0 0 0 0 0 0
0 0 0 0 0 0 0 0 0 0 0 0 0 0 0 0 6 6 6 6 6 2 0 0 0 0 0 0 0 0 0 0
0 0 0 0 0 0 0 0 0 0 0 0 0 0 0 0 0 0 0 0 0 8 0 0 0 0 0 0 0 0 0 0
0 0 0 0 0 0 0 0 0 0 0 0 0 0 0 0 0 0 0 0 0 0 0 0 0 0 0 0 0 0 0 0
7 7 7 7 7 7 1 0 0 0 0 0 0 0 0 0 0 0 0 0 0 0 0 0 7 7 7 0 0 7 7 7
4 4 4 4 4 8 0 0 0 0 0 0 0 0 0 0 0 0 0 0 0 0 0 0 0 4 0 0 0 0 0 0
4 4 4 4 8 0 0 0 0 0 0 0 0 0 7 7 7 7 7 7 7 7 7 0 0 4 0 0 0 0 0 0
4 4 4 8 0 0 0 0 0 0 0 0 0 0 0 0 0 0 0 0 0 0 0 0 0 4 0 0 0 0 0 0
4 4 8 0 0 0 0 0 0 0 0 0 0 0 0 0 0 0 0 0 0 0 0 0 0 4 0 0 0 0 0 0
4 2 0 0 0 0 0 0 0 0 0 0 0 0 0 0 0 0 0 0 0 0 0 0 0 4 0 0 0 0 0 0
4 2 0 0 0 0 0 0 0 0 0 0 0 0 0 0 0 0 0 0 0 0 0 0 0 0 0 0 0 0 0 0
4 2 0 0 0 0 0 0 0 0 0 0 0 3 1 0 0 0 0 0 0 0 0 0 0 0 0 0 0 0 0 0
4 2 0 0 0 0 0 0 0 0 0 0 3 4 4 1 0 0 0 0 0 0 0 0 3 1 0 0 0 0 0 0
4 4 7 7 7 7 7 0 0 3 7 7 4 4 4 4 7 7 7 7 7 7 7 7 4 4 7 7 7 7 7 7
4 4 4 4 4 4 4 0 0 4 4 4 4 4 4 4 4 4 4 4 4 4 4 4 4 4 4 4 4 4 4 4
4 4 4 4 4 4 4 0 0 4 4 4 4 4 4 4 4 4 4 4 4 4 4 4 4 4 4 4 4 4 4 4


88 300 0

9
300 225
225 275
225 325
950 200
950 265
300 100
350 100
873 350
650 525

3
830 390 1
900 390 1
970 390 1

120 30

50 60 0

1
65 410

1
778 30

1
972 98

2
1 520 142 600 142 520 142
3 546 366 640 366 546 366

1
428 320

1
506 160
2
864 130 1
225 415 1